Map1
106030000.img
106030100.img
106030102.img
106030200.img
106030201.img
106030210.img
106030211.img
106030300.img
106030301.img
106030302.img
106030401.img
106030402.img
106030500.img
106030501.img
106030502.img
106030700.img
106030701.img

--------------------------------------------------------

Map2
211000000.img
250000000.img
--------------------------------------------------------

Map8
811000000.img
811000014.img
811000015.img
811000016.img
811000017.img
811000018.img
811000019.img
811000020.img
811000021.img
811000025.img
811000026.img
811000027.img
811000028.img
811000029.img
811000031.img
811000033.img

811000040.img
811000050.img
811000060.img
811000070.img
811000080.img

811000096.img
811000097.img
811000098.img
811000099.img
--------------------------------------------------------

Map9
910000000.img
910000001.img
910000002.img
910000003.img
910000004.img
910000005.img
910000006.img
910000007.img
910000008.img
910000009.img
910000010.img
910000011.img
910000012.img
910000013.img
910000014.img
910000015.img
910000016.img
910000017.img
910000018.img
910000019.img
910000020.img
910000021.img
910000022.img

992000010.img
992000020.img
992000030.img
992000040.img
992000050.img
992000060.img
992000070.img
992000080.img
992000090.img

992003000.img
992004000.img
992005000.img
992006000.img
992007000.img
992008000.img
992009000.img
992010000.img
992011000.img
992012000.img
992013000.img
992014000.img
992014001.img
992014002.img
992015000.img
992016000.img
992017000.img
992018000.img
992019000.img
992020000.img
992021000.img
992022000.img

992024000.img
992025000.img
992026000.img

992028000.img
992029000.img
992030000.img
992031000.img
992032000.img
992033000.img
992034000.img
992035000.img
992036000.img
992037000.img
992038000.img
992039000.img
992040000.img
992041000.img
992042000.img
992043000.img
992044000.img
992045000.img
992046000.img
992047000.img
992048000.img
992049000.img
992050000.img
--------------------------------------------------------